0
1'0'0'0'0'0'0'0'0'0'0'0'0'0'0'0'0'0'0'0'0'0'0'0'0'0'0'0'0'0'0'0'0'0'0'0'0'0'0'0'0'0'0'0'0'0'0'0'0'0'0'0'0'0'0'0'0'0'0'0'0'0'0'0'0'0'0'0'1'
1'0'0'0'0'0'0'0'0'0'0'0'0'0'0'0'0'0'0'0'0'0'0'0'0'0'0'0'0'0'0'0'0'0'0'0'0'0'0'0'0'0'0'0'0'0'0'0'0'0'0'0'0'0'0'0'0'0'0'0'0'0'0'0'0'0'0'0'1'
1'0'0'0'0'0'0'0'0'0'0'0'0'0'0'0'0'0'0'0'0'0'0'0'0'0'0'0'0'0'0'0'0'0'0'0'0'0'0'0'0'0'0'0'0'0'0'0'0'0'0'0'0'0'0'0'0'0'0'0'0'0'0'0'0'0'0'0'1'
1'0'0'0'0'0'0'0'0'0'0'0'0'0'0'0'0'0'0'0'0'0'0'0'0'0'0'0'0'0'0'0'0'0'0'0'0'0'0'0'0'0'0'0'0'0'0'0'0'0'0'0'0'0'0'0'0'0'0'0'0'0'0'0'0'0'0'0'1'
1'0'0'0'0'0'0'0'0'0'0'0'0'0'0'0'0'0'0'0'0'0'0'0'0'0'0'0'0'0'0'0'0'0'0'0'0'0'0'0'0'0'0'0'0'0'0'0'0'0'0'0'0'0'0'0'0'0'0'0'0'0'0'0'0'0'0'0'1'
1'0'0'0'0'0'0'0'0'0'0'0'0'0'0'0'0'0'0'0'0'0'0'0'0'0'0'0'0'0'0'0'0'0'0'0'0'0'0'0'0'0'0'0'0'0'0'0'0'0'0'0'0'0'0'0'0'0'0'0'0'0'0'0'0'0'0'0'1'
1'0'0'0'0'0'0'0'0'0'0'0'0'0'0'0'0'0'0'0'0'0'0'0'0'0'0'0'0'0'0'0'0'0'0'0'0'0'0'0'0'0'0'0'0'0'0'0'0'0'0'0'0'0'0'0'0'0'0'0'0'0'0'0'0'0'0'0'1'
1'0'0'0'0'0'0'0'0'0'0'0'0'0'0'0'0'0'0'0'0'0'0'0'0'0'0'0'0'0'0'0'0'0'0'0'0'0'0'0'0'0'0'0'0'0'0'0'0'0'0'0'0'0'0'0'0'0'0'0'0'0'0'0'0'0'0'0'1'
1'0'0'0'0'0'0'0'0'1'0'0'0'0'254'0'0'0'0'0'201'0'0'1'0'0'0'0'0'0'0'0'0'0'0'0'0'0'0'0'0'0'0'0'0'0'0'0'0'0'0'0'0'0'0'0'0'0'0'0'0'0'0'0'0'0'0'0'1'
1'0'0'0'0'0'0'0'0'1'0'0'0'0'0'0'0'0'0'0'202'0'0'1'0'0'0'0'0'0'0'0'0'0'0'0'0'0'0'0'0'0'0'0'0'0'0'0'0'0'0'0'0'0'0'0'0'0'0'0'0'0'0'0'0'0'0'0'1'
1'0'0'0'0'0'0'0'0'0'0'0'0'0'0'0'0'0'0'0'0'0'0'0'0'0'0'0'0'0'0'0'0'0'0'0'0'0'0'0'0'0'0'0'0'0'0'0'0'0'0'0'0'0'0'0'0'0'0'0'0'0'0'0'0'0'0'0'1'
1'0'0'0'0'0'0'0'0'0'0'0'0'0'0'0'0'0'0'0'0'0'0'0'0'0'0'0'0'0'4'0'201'0'0'0'0'0'0'0'0'0'0'0'0'0'0'0'0'13'13'13'13'13'0'0'0'0'0'0'0'0'0'0'0'0'0'0'1'
1'0'0'0'0'0'0'0'0'0'0'0'0'0'0'0'0'0'0'0'0'0'0'0'0'0'0'0'0'0'4'0'0'0'0'0'0'0'0'0'0'0'0'0'0'0'0'0'0'13'0'0'0'13'0'0'0'0'0'0'0'0'0'0'0'0'0'0'1'
1'0'1000'0'0'0'0'0'0'0'0'0'326'0'0'0'0'0'0'0'0'0'0'0'0'0'0'0'0'0'4'0'0'0'0'0'0'0'0'0'0'0'0'0'0'0'0'0'0'13'0'0'0'13'0'0'0'0'0'0'0'0'0'0'0'0'0'0'1'
1'0'0'0'0'0'0'0'0'0'0'0'326'0'0'0'0'0'0'0'0'0'0'0'0'0'0'0'0'0'4'0'0'0'402'0'0'0'0'0'0'0'0'0'406'406'0'0'0'0'0'0'13'0'0'0'0'0'0'0'0'0'0'0'0'0'0'0'1'
1'0'0'0'0'403'403'404'403'404'0'0'326'0'0'0'0'0'0'0'0'0'0'0'0'0'0'0'0'3'3'3'3'3'3'3'3'3'6'6'7'7'7'3'13'0'0'0'13'0'0'0'0'0'0'401'0'401'0'0'0'0'0'0'0'0'0'0'1'
1'0'3'3'3'3'3'3'3'3'3'3'3'17'17'17'17'17'17'17'17'17'17'17'17'17'17'17'17'2'2'2'2'2'2'2'2'2'2'2'2'2'2'6'6'6'6'3'3'3'3'3'0'5'5'5'5'5'5'3'3'3'3'3'3'3'3'3'1'
1'0'2'2'2'2'2'2'2'2'2'2'2'2'2'2'2'2'2'2'2'2'2'2'2'2'2'2'2'2'2'2'2'2'2'2'2'2'2'2'2'2'2'2'2'2'2'2'2'2'2'2'2'5'5'5'5'5'5'2'2'2'2'2'2'2'2'2'1'
1'0'1'1'1'1'1'1'1'1'1'1'1'1'1'1'1'1'1'1'1'1'1'1'1'1'1'1'1'1'1'1'1'1'1'1'1'1'1'1'1'1'1'1'1'1'1'1'1'1'1'1'1'1'1'1'1'1'1'1'1'1'1'1'1'1'1'1'1'
