1
1'0'0'0'0'0'0'0'0'0'0'0'0'0'0'0'0'0'0'0'0'0'0'0'0'0'0'0'0'0'0'0'0'0'0'0'0'0'0'0'0'0'0'0'0'0'0'0'0'0'0'0'0'0'0'0'0'0'0'0'0'0'0'0'0'0'0'0'1'
1'0'0'0'0'0'0'0'0'0'0'0'0'0'0'0'0'0'0'0'0'0'0'0'0'0'0'0'0'0'0'0'0'0'0'0'0'0'0'0'0'0'0'0'0'0'0'0'0'0'0'0'0'0'0'0'0'0'0'0'0'0'0'0'0'0'0'0'1'
1'0'0'0'0'0'0'0'0'0'0'0'0'0'0'0'0'0'0'0'0'0'0'0'0'0'0'0'0'0'0'0'0'0'0'0'0'0'0'0'0'0'0'0'0'0'0'0'0'0'0'0'0'0'0'0'0'0'0'0'0'0'0'0'0'0'0'0'1'
1'0'0'0'0'0'0'0'0'0'0'0'0'0'0'0'0'0'0'0'0'0'0'0'0'0'0'0'0'0'0'0'0'0'0'0'0'0'0'0'0'0'0'0'0'0'0'0'0'0'0'0'0'0'0'0'0'0'0'0'0'0'0'0'0'0'0'0'1'
1'0'0'0'0'0'0'0'0'0'0'0'0'0'0'0'0'0'0'0'0'0'0'0'0'0'0'0'0'0'0'0'0'0'0'0'0'0'0'0'0'0'0'0'0'0'0'0'0'0'0'0'0'0'0'0'0'0'0'0'0'0'0'0'0'0'0'0'1'
1'0'0'0'0'0'0'0'0'0'0'0'0'0'0'0'0'0'0'0'0'0'0'0'0'0'0'0'0'0'0'0'0'0'0'0'0'0'0'0'0'0'0'0'0'0'0'0'0'0'0'0'0'0'0'0'0'0'0'0'0'0'0'0'0'0'0'0'1'
1'0'0'0'0'0'0'0'0'0'0'0'0'0'0'0'0'0'0'0'0'0'0'0'0'0'0'0'0'0'0'0'0'0'0'0'0'0'0'0'0'0'0'0'0'0'0'0'0'0'0'0'0'0'0'0'0'0'0'0'0'0'0'0'0'0'0'0'1'
1'0'0'0'0'0'0'0'0'0'0'0'0'0'0'0'0'0'0'0'0'0'0'0'0'0'0'0'0'0'0'0'0'0'0'0'0'0'0'0'0'0'0'0'0'0'0'0'0'0'0'0'0'0'0'0'0'0'0'0'0'0'0'0'0'0'0'0'1'
1'0'0'0'0'0'0'0'0'1'0'0'0'0'0'0'0'0'0'0'201'0'0'1'0'0'0'0'0'0'0'0'0'0'0'0'0'0'0'0'0'0'0'0'0'0'0'0'0'0'0'0'0'0'0'0'0'0'0'0'0'0'0'0'0'0'0'0'1'
1'0'0'0'0'0'0'0'0'1'0'0'0'0'0'0'0'0'0'0'0'0'0'1'0'0'0'0'0'0'0'0'0'0'0'0'0'0'0'0'0'0'0'0'0'0'0'0'0'0'0'0'0'0'0'0'0'0'0'0'0'0'0'0'0'0'0'0'1'
1'0'0'0'0'0'0'0'0'0'0'0'0'0'0'0'0'0'0'0'0'0'0'0'0'0'0'0'0'0'0'0'0'0'0'0'0'0'0'0'0'0'0'0'0'0'0'0'0'0'0'0'0'0'0'0'0'0'0'0'0'0'0'0'0'0'0'0'1'
1'0'0'0'0'0'0'0'0'0'0'0'0'0'0'0'0'0'0'0'0'0'0'0'0'0'0'0'0'0'4'0'201'0'0'0'0'0'0'0'0'0'0'0'0'0'0'0'0'13'13'13'13'13'0'0'0'0'0'0'0'0'0'0'0'0'0'0'1'
1'0'0'0'0'301'301'301'0'0'0'0'303'303'0'303'303'0'303'303'0'303'0'303'0'0'0'0'0'0'4'0'0'0'0'0'0'0'0'0'0'0'0'0'0'0'0'0'0'13'0'0'0'13'0'0'0'0'0'0'0'0'0'0'0'0'0'0'1'
1'0'1000'0'0'0'0'0'0'0'1000'0'0'0'0'0'0'0'0'0'0'0'0'0'0'0'0'0'0'0'4'0'0'0'0'0'0'0'0'0'0'0'0'0'0'0'0'0'0'13'0'0'0'13'0'0'0'0'0'0'0'0'0'0'0'0'0'0'1'
1'0'0'0'0'0'0'0'0'0'0'0'0'666'0'0'0'0'0'0'0'0'0'0'0'0'0'0'0'0'4'0'0'0'402'0'0'0'0'0'0'0'380'380'380'380'380'380'380'380'380'0'13'0'0'0'0'0'0'0'0'0'0'0'0'0'0'0'1'
1'0'0'0'0'403'403'404'403'404'0'0'0'0'0'0'0'0'0'0'0'0'0'0'0'0'0'0'0'3'3'3'3'3'3'3'3'3'6'6'7'7'378'378'378'378'378'378'378'378'378'0'0'0'0'401'0'401'0'0'0'0'0'0'0'0'0'0'1'
1'0'3'3'3'3'3'3'3'3'3'3'3'1'1'1'1'1'1'1'1'1'1'1'1'1'1'1'1'2'2'2'2'2'2'2'2'2'2'2'2'2'378'378'378'378'378'378'378'378'378'378'0'5'5'5'5'5'5'3'3'3'3'3'3'3'3'3'1'
1'0'2'2'2'2'2'2'2'2'2'2'2'2'2'2'2'2'2'2'2'2'2'2'2'2'2'2'2'2'2'2'2'2'2'2'2'2'2'2'2'2'378'378'378'378'378'378'378'378'378'2'2'5'5'5'5'5'5'2'2'2'2'2'2'2'2'2'1'
1'0'1'1'1'1'1'1'1'1'1'1'1'1'1'1'1'1'1'1'1'1'1'1'1'1'1'1'1'1'1'1'1'1'1'1'1'1'1'1'1'1'1'1'1'1'1'1'1'1'1'1'1'1'1'1'1'1'1'1'1'1'1'1'1'1'1'1'1'
